NO textures/walls1.xpm
SO textures/walls2.xpm
WE textures/walls3.xpm
EA textures/walls4.xpm

C 75, 75, 255
F 50, 50, 50

1111111111111111111111111   
1000000000110000000000001
1011000001110000000000001
100100000000000000000000111111111
111111111011000001110000000000001
100000000110000001100111111111111
11110111111111011111000010001
11110111111111011101010010001
11000000110101011100000000001
10000000000000001100010S10001
10000000000000001101000000001
1100000111010101111100000011
11111111 1110101 101111010001
1111 111 1111111 111111111111