NO textures/walls1.xpm
SO textures/walls2.xpm
WE textures/walls3.xpm
EA textures/walls4.xpm

F 220,100,0
C 225,30,0

		11111111111
	11111     00011
1111100000     00011
110001111   000  011	
11     11000  11 101
11   11     000011
11000000W0000   111
11    000000 0 0001
1111		00	  1
1111111111111111111
111100000000000000011