11111111			
	10000001
	10011001
10011001
11111111		
	