11111111
10000001
1000P001
10011001
11111111