NO walls1.xpm
SO walls2.xpm
WE walls3.xpm
EA walls4.xpm

F 220,100,0
C 225,30,0

11111111
10000001
1000W001
10011001
11111111