NO textures/north.xpm
SO textures/south.xpm
WE textures/west.xpm
EA textures/east.xpm

F 45,33,16
C 111,98,232

1111111111111111111111111
1000000000110000000000001
1011000001110000000000001
1001000000000000000000001
111101111011000001110000011111111
100000000011000001110111111111111
11110111111111011100000010001
11110111111111011101111111001
11000000110101011100100001001
11000000000000001100101111001
10000000000000001101101 10001
110000N1110101011111101 1000111
10000000000000000000001 10001
11110000111111111111111 11111
   111111