NO textures/walls1.xpm
SO textures/walls2.xpm
WE textures/walls3.xpm
EA textures/walls4.xpm

C 75, 75, 255
F 50, 50, 50

		11111111111
	11111     00011
1111100000     00011
110001111   000  011	
11     11000  11 101
11   11     000011
11000000W0000   111
11    000000 0 0001
111			00	  1
1111111111111111111
111100000000000000011
