NO textures/walls1.xpm
SO textures/walls2.xpm
WE textures/walls3.xpm
EA textures/walls4.xpm

C 75, 75, 255
F 50, 50, 50

11111111
10000001
1000N001
10011001
11111111